Cancel=Annuler

; My PSAs / banners
Happy New Year=Bonne Année
Happy Holidays from Andrew, Tracey, and family=Joyeuses Fêtes de la part de Andrew, Tracey, et toute la famille
Please Enjoy Responsibly=S'il vous plaît utiliser de manière responsable
Popup Blocked CA requires popups to be enabled under certain circumstances You must white list your server within your browser to allow popups=Popup Bloqué. CA nécessite que les popups soient activés dans certaines circonstances Vous devez lister votre serveur dans votre navigateur pour autoriser les popups
Docker Service Not Enabled - Only Plugins Available To Be Installed Or Managed=Service Docker Non-Activé - Seuls les plugins disponibles peuvent être installés ou gérés
Community Applications works best when cookies are enabled in your browser Certain features may not be available=Les Applications Communautaires fonctionnent mieux lorsque les fichiers témoins (cookies) sont activés dans votre navigateur Certaines fonctionnalités peuvent ne pas être disponibles
Backup Server Active Some icons may not appear, and plugin installations may be affected=Serveur de sauvegarde actif Certains icônes peuvent ne pas apparaître et les installations de plug-ins peuvent être affectées

; Sorting Options
Sorting options=Options de Tri
Sorting options unavailable=Options de Tri non-disponibles
Sort By Name Ascending=Trier Par Nom Ascendant
Sort By Name Descending=Trier Par Nom Descendant
Sort By Downloads=Trier Par Téléchargements
Sort By Trend=Trier Par Tendance
Sort By Date Added=Trier Par Date Ajouté
; Initial disclaimer translations
Disclaimer=Désistement
All applications listed here are 3rd party additions to Unraid Neither the authors of Community Applications nor Limetech make any warranty as to the suitability of any application listed here=Toutes les applications répertoriées ici sont des ajouts de tierce-partie à unRaid. Ni les auteurs des applications communautaires ni Limetech ne donnent de garantie quant à la validité de toute application répertoriée ici.
Every attempt is made to ensure that only safe and compatible applications are present=Tous les efforts sont faits pour s'assurer que seules des applications sûres et compatibles sont présentes
Application Policy=Politique d'Application
I Understand=Je Comprends
Installations of apps disabled You must accept the warning to be able to install applications=Installations d'applications désactivées Vous devez accepter l'avertissement pour pouvoir installer des applications
Click here=Cliquez ici

; Plugin Disclaimer
Community Applications contains both docker containers and plugin applications Plugins are designed for OS enhancements, and run with full privileges on your system and are clearly identified within CA=Les applications de communauté contiennent à la fois des conteneurs de docker et des applications de plugin. Les plugins sont conçus pour des améliorations du système d'exploitation, et s'exécutent avec des privilèges complets sur votre système et sont clairement identifiés dans CA
Plugin Note=Note du Plugin

; Multi Install
Install Plugin Applications=Installer les Application de Plugins
Select all on page=Sélectionner tout sur la page

; Searches
Search=Recherche
Please enter search term=Veuillez entrer le terme de recherche
Click Here To Get More Results From DockerHub=Cliquer Ici Pour Obtenir Plus De Résultats De Recherche De Dockerhub
No Matching Applications Found On Docker Hub=Aucune Application Correspondante Trouvée sur DockerHub
No Matching Applications Found=Aucune Application Correspondante Trouvée

; Install Plugin title of openbox
Install Plugin=Installer Plugin

; Remove App from previously installed
Delete Template=Supprimer le Modèle
Yes, delete it=Oui, supprimez la

; Uninstall popup
Uninstall Application=Désinstaller l'Application
Yes uninstall it=Oui désinstallez la

; Remove Private Application
Remove Private Application=Retirer l'Application Privée
Yes, remove it=Oui, retirez-la

; App Pinning
Click to pin this application=Cliquez pour épingler cette application
Click to unpin this application=Cliquez pour désépingler cette application

; Branch installations
Choose A Branch To Install=Choisir la Branche a Installer

; Multiple application installs
; no apps selected
Install Selected Applications=Installer les Applications Épinglées

Yes, install it=Oui, Installez La

; Multi-install popup
Yes, install them=Oui, Installez les
Cookies not enabled Plugins must be separately installed from docker applications=Fichiers Témoins (Cookies) non activés. Les Plugins doivent être installés séparément des applications docker
Docker applications will be installed utilizing the most recently saved template with no user input on your part=Les applications Docker seront installées en utilisant le modèle le plus récemment sauvegardé, sans aucune intervention de votre part
Updating Support Links=Mise à jour des Liens de Soutien
Finished Installing If the DONE button did not appear, then you will need to click the red X in the top right corner=Installation Terminée. Si le bouton TERMINÉ n'apparaît pas, vous devez cliquer sur le X rouge dans le coin supérieur droit

; error messages
No data was returned It is probable that another browser session has rebooted your server Reloading this browser tab will probably fix this error=Aucune donnée n'a été renvoyée. Il est probable qu'une autre session de navigateur ait redémarré votre serveur. Le rechargement de cet onglet du navigateur corrigera probablement cette erreur
An error occurred Could not find any %s Apps=Une erreur s'est produite. Impossible de trouver aucune Application de %s
Download of appfeed failed=Le téléchargement de l'appfeed a échoué
; the %s here refers to a function being called
Something really went wrong here=Quelque chose s'est vraiment mal passé ici
Post the ENTIRE contents of this message in the Community Applications Support Thread=Soumettre le contenu ENTIER de ce message dans le fil de discussion du soutien aux applications communautaires
Unknown error happened Please post a screenshot in the support thread of the Statistics screen=Une erreur inconnue s'est produite. Veuillez poster une capture d'écran dans le fil de soutien de la page de Statistiques
Something really wrong happened Reloading the Apps tab will probably fix the problem=Quelque chose s'est vraiment mal passé. Recharger l'onglet d'Applications va probablement régler le problème
This plugin has a duplicated name from another plugin %s This will impact your ability to install both plugins simultaneously=Ce plugin a un nom dupliqué d'un autre plugin %s Cela aura un impact sur votre capacité à installer les deux plugins simultanément
You have been logged out=Vous avez été déconnecté

; CA Sections Keep the length reasonable
MENU=MENU
Installed Apps=Applications Installées
Previous Apps=Applications Précédentes
Pinned Apps=Applications Épinglées
CATEGORIES=CATÉGORIES
New Apps=Nouvelles Applications
Updated Apps=Applications Mises-à-jour
Random Apps=Applications Aléatoires
Top New Installs=Top Des Nouvelles Installations
Trending Apps=Applications Tendance
All Apps=Toutes Les Applications
OTHER=AUTRES
Statistics=Statistiques
Credits=Crédits
Support=Support
VERSION=VERSION
Change Log=Journal Des Modifications

; Credits
Development=Développement
Additional Contributions=Contributions Supplémentaires
GUI Layout Design=Conception De L'interface Graphique
Application Feed=Feed d'Applications
Additional Testing=Tests Supplémentaires
Moderation=Modération
Additional Libraries=Librairies Supplémentaires
Copyright=Droits D'Auteur
Translation=Traduction

; Statistics page
Deprecated Applications are able to still be installed if you have previously had them installed New installations of these applications are blocked unless you enable Display Deprecated Applications within CAs General Settings=Les Applications Obsolètes peuvent toujours être installées si vous les avez déjà installé. Les nouvelles installations de ces applications sont bloquées à moins que vous n'activiez l'Affichage des Applications Obsolètes dans les Paramètres Généraux du CA
The following applications are blacklisted CA will never allow you to install or reinstall these applications=Les applications suivantes sont sur la liste noire. CA ne vous permettra jamais d'installer ou de réinstaller ces applications
While highly not recommended to do, incompatible applications can be installed by enabling Display Incompatible Applications within CAs General Settings=Bien qu'il soit fortement déconseillé de le faire, des applications incompatibles peuvent être installées en activant l'option Afficher les Applications Incompatibles dans les Paramètres Généraux des CA
This display is informational ONLY=Cet affichage est à titre d'information UNIQUEMENT
unknown=inconnu
Last Change To Application Feed=Dernier Changement au Feed d'Applications
Number Of Docker Applications=Nombre d'Applications Docker
Number Of Plugin Applications=Nombre d'Applications Plugin
Number Of Templates=Nombre de Modèles
Number Of Repositories=Nombre de dépôts
Number Of Private Docker Applications=Nombre d'Application Docker Privées
Number Of Invalid Templates=Nombre de Modèles Invalides
Number Of Template Errors=Nombre d'Erreurs de Modèles
Number Of Blacklisted Apps=Nombre d'Applications sur la liste noire
Number Of Incompatible Applications=Nombre d'Applications Incompatibles
Number Of Deprecated Applications=Nombre d'Applications obsolètes
Number Of Moderation Entries=Nombre d'Entrées de Modération
Primary Server=Serveur Primaire
Backup Server=Serveur de Sauvegarde

; Statistics Popup Titles
Repository List=Liste des Dépots
All Invalid Templates Found=Tous les Modèles Invalides Trouvés
Template Errors=Erreurs de Modèle(s)
All Moderation Entries=Toutes les Entrées de Modération

; Statistics Popup
No invalid templates found=Aucun modèle invalide trouvé
These templates are invalid and the application they are referring to is unknown=Ces modèles ne sont pas valides et l'application à laquelle ils font référence est inconnue
No templates were automatically fixed=Aucun modèle n'a été automatiquement réparé
All of these errors found have been fixed automatically=Toutes ces erreurs trouvées ont été automatiquement réparées
Note that many of these errors can be avoided by following the directions=Notez que plusieurs de ces erreurs peuvent être évitées en suivant les instructions
HERE=ICI
The following plugins have duplicated filenames and are not able to be installed simultaneously=Les plugins suivants ont des noms de fichiers dupliqués et ne peuvent pas être installés simultanément
The following docker applications refer to the same docker repository but may have subtle changes in the template to warrant this=Les Applications docker suivantes se réfèrent au même dépôt de docker mais peuvent avoir des changements subtils dans le modèle pour justifier ceci
If any of these entries are incorrect then contact the moderators of CA to discuss=Si l'une de ces entrées est incorrecte, contactez les modérateurs du CA pour discuter
Global Repository Comments=Commentaires Globaux sur le Dépot
Applied to all applications=(Appliqué à toutes les Applications)
Individual Application Moderation=Modération Individuelle des Applications

; Misc
Community Applications Changelog=Changelog des Applications Communautaires

; Categories try not to be excessively long This is displayed on the left of CA screen

Backup=Sauvegarde
Cloud=Cloud
Downloaders=Téléchargeurs
Game Servers=Serveurs de Jeux
Home Automation=Domotique
Media Applications=Applications Media
Books=Livres
Music=Musique
Photos=Photos
Video=Vidéo
Other=Autre
Media Servers=Serveurs Media
Network Services=Services Réseau
DNS=DNS
FTP=FTP
Management=Gestion
Messenger=Messenger
Proxy=Serveur Proxy
VOIP=VOIP
VPN=VPN
Web=Web
Productivity=Productivité
Security=Sécurité
Tools Utilities=Outils Utilitaires
System=Système
Themes=Thêmes
Utilities=Utilitaires
Private Apps=Applications Privées
Uncategorized=Non-Catégorisé

; Categories displayed within a popup or on the card.  Where an entry exists after the "=" it is not translated, but rather how it should look
GameServers=Serveurs de Jeux
HomeAutomation=Domotique
MediaApp=Appli Média
MediaAppBooks=Appli Média:Livres
MediaAppMusic=Appli Média:Musique
MediaAppPhotos=Appli Média:Photos
MediaAppVideo=Appli Média:Vidéo
MediaAppOther=Appli Média:Autre
MediaServer=Serveur:Media
MediaServerBooks=Serveur Média:Livres
MediaServerMusic=Serveur Média:Musique
MediaServerPhotos=Serveur Média:Photos
MediaServerVideo=Serveur Média:Vidéo
MediaServerOther=Serveur Média:Autre
Network=Réseau
NetworkDNS=Réseau:DNS
NetworkFTP=Réseau:FTP
NetworkManagement=Réseau:Gestion
NetworkProxy=Réseau:Proxy
NetworkVOIP=Réseau:VOIP
NetworkVPN=Réseau:VPN
NetworkWeb=Réseau:Web
NetworkOther=Réseau:Autre
ToolsSystem=Outils:Système
ToolsThemes=Outils:Thêmes
ToolsUtilities=Outils:Utilitaires
Other=Autres
OtherUncategorized=Autres:Non-catégorisé
and %s more=et %s de plus

; App Popup Related
Donate To Author=Faire un Don a l'Auteur
Donate To Maintainer=Faire un Don au Mainteneur
Author=Auteur
Maintainer=Responsable
DockerHub=DockerHub
Application Template=Modèle d'Application
Base OS=SE de Base
DockerHub Stars=Étoiles DockerHub
Added to CA=Ajouté au CA
Date Updated=Date de mise-à-jour
Current Version=Version Actuelle
Minimum OS=SE Minimal
Max OS=SE Maximum
Total Downloads=Nombre Total de Téléchargements
Licence=Licence
30 Day Trend=Tendance sur 30 jours
Ranked #%s=Coté #%s
; as in Trending up or down arrow
Trending %s=Tendance %s
; as in As of some date
As of %s=À partir de %s
This application template has been blacklisted=Cette application ou modèle a été mise sur la liste noire
This application template has been deprecated=Cette application ou modèle a été dépréciée
This application is not compatible with your version of unRaid=Cette application n'est pas comptible avec votre version de unRaid
Another browser tab or device has updated the displayed templates Some actions are not available=Un autre onglet ou navigateur a mis à jour les modèles affichés Certaines actions ne sont pas disponibles
Reinstall default=Réinstaller (par défaut)
WebUI=WebUI
Reinstall=Réinstaller
Install=Installer
Project=Projet
Install Using The Templates Default Tag=Installer à l'aide de la balise par défaut des modèles
Moderator Comments=Commentaires du Modérateur:
Note not all authors keep up to date on change logs=Notez que tous les auteurs ne sont pas à jour sur les journaux de modifications
Note not all maintainers keep up to date on change logs=Notez que tous les mainteneurs ne sont pas à jour sur les journaux de modifications
;the following if using a space you MUST use nbsp but keep it down to one word if at all possible
Donate=Dons
Currently Installed Version=Version Installée
Install The Update=Installer la Mise-à-jour
; as in you have the latest version already installed
Latest Version=Dernière Version
Multi Language Support=Prise en charge Multilingue
; as in more than 100000
More than %s=Plus de %s

; Graphs
Trend Per Month=Tendance Par Mois
Downloads Per Month=Téléchargements Par Mois
Total Downloads=Nombre Total de Téléchargements

; Multi install script
Installing docker applications %s=Installation des dockers %s
Starting %s=Démarrage de %s
%s failed to start You should install it by itself to fix the errors=Le démarrage de %s a échoué Vous devriez l'installer seul pour corriger les erreurs
Setting installed applications to autostart=Configuration des applications installées pour démarrage automatique
Docker Application Installation finished=Installation de l'Application Docker terminée

; Application Cards
Private dockerHub Conversion=Private (dockerHub Conversion)
Go to the project page=Aller à la page du projet
Go to the support thread=Aller au fil de soutien
Uninstall Application=Désinstaller l'Application
Remove Private Application=Retirer l'Apllication Privée
Remove Application From List=Retirer l'Application de la liste
Check off to select multiple reinstalls=Décocher pour sélectionner des réinstallations multiples
Go to the plugin settings=Aller aux paramètres du plugin
Click to reinstall the application using default values=Cliquez pour réinstaller l'application avec les valeurs par défaut
Click to edit the application values=Cliquez pour modifier les valeurs de l'application
Click to reinstall=Cliquez pour réinstaller
Click to install=Cliquez pour installer
Install plugin=Installer le plugin
Click to go to the WebUI=Cliquez pour aller à l'interface Web
This application has been marked as being Beta=Cette application a été marquée comme étant Bêta
This application template has been deprecated=Ce modèle d'application est obsolète
This application is not compatible with your version of Unraid=Cette application n'est pas compatible avec votre version de Unraid
This application template has been blacklisted=Ce modèle d'application a été mis sur la liste noire
Search for more applications from %s=Rechercher pour plus d'applications à partir de %s
Click for more information=Cliquez pour plus d'informations

; Dockerhub searches
Search For Containers From %s=Rechercher des Conteneurs à partir de %s
Search for similar containers=Rechercher des Conteneurs similaires

;Page Navigation
Displaying %s - %s of %s=Affichage %1$s - %2$s (de %3$s)

Updating Content=Mise-à-jour du contenu
Language=Langue
Switch to this language=Passer à cette langue
Country Code=Code de Pays
Install Language Pack=Installer le Module Linguistique
Remove Language Pack=Désinstaller le Module Linguistique
Update Language Pack=Mettre a jour le Module Linguistique
Installed Version=Version Installée
A note about translations=A propos des traductions
Click here to view the language changelog=Cliquer ici pour voir le changelog de la langue

; Help Text
This chooses how to sort the results=Cela choisit comment trier les résultats
These icons respectively will Install or Edit an application=Ces icônes Installeront ou Modifieront une application
Clicking these icons will take you to an applications GUI or settings=En cliquant sur ces icônes, vous accéderez à l'interface graphique ou aux paramètres d'une application
This will update an application=Cela mettra à jour une application
This will take you to the appropriate support thread for an application=Cela vous amènera au fil de support approprié pour une application
This will immediately switch to the language=Cela passera immédiatement à la langue
This will take you to the project page for an application=Cela vous amènera à la page du projet pour une application
Clicking this icon will uninstall the application or delete it from the lists depending upon your current section=Cliquez sur cette icône pour désinstaller l'application ou la supprimer des listes en fonction de votre section actuelle
Clicking these icons will pin or unpin an application for later viewer from the Pinned Apps section=Cliquez sur ces icônes pour épingler ou annuler l'épinglage d'une application pour un visionnement ultérieur dans la section Applications épinglées
Clicking this will display more information about the application NOTE You can also click on the applications icon to display more information=Cliquez pour afficher plus d'informations sur l'application REMARQUE Vous pouvez également cliquer sur l'icône des applications pour afficher plus d'informations
Clicking this will display any warnings or extra comments about the application=Cliquez pour afficher tous les avertissements ou commentaires supplémentaires concernant l'application
On the previous apps section you can select multiple applications to install simultaneously=Dans la section des applications précédentes, vous pouvez sélectionner plusieurs applications à installer simultanément
This is the recommended version to install by the application author themselves=Il s'agit de la version recommandée à installer par l'auteur de l'application lui-même
For support for this plugin visit=Pour le soutien de ce plugin, visitez
To view the policies Community Applications has=Pour afficher les politiques, les applications communautaires ont
